** ********** ********
** ****  **** ********
** ********** ********
**      ***** ********
** ********** ********
**      *****      ***
***** * ***** ********
** ********** ********
**            ********
***** * ***** ********
*     *   *** ********
* ******* ************
* *********** ****    
** **************  ***
**      ***** **  ****
***** * *****    *****
*     *   *** ********
* ******* *** ********
* *********** ********
*     *   *** ********
* ******* *** ********
