* *******
*   * * *
* ***** *
* * *   *
* * *** *
*   *   *
***** * *
*     * *
******* *