** ********
** ********
**      ***
***** * ***
*     *   *
* ******* *
* *********